num1,num2,num3,num4,num5,Sum
71,96,89,22,65,343
80,38,34,77,79,308
57,54,14,86,99,310
42,81,91,37,48,299
88,27,58,47,30,250
30,1,33,65,29,158
29,59,5,19,85,197
11,41,99,47,4,202
45,74,14,27,36,196
13,25,15,62,78,193
17,27,26,59,17,146
9,73,70,26,63,241
33,74,29,91,45,272
42,4,34,59,76,215
47,86,24,29,8,194
13,65,11,90,54,233
90,89,74,44,59,356
96,76,34,49,46,301
15,93,31,31,22,192
81,17,13,65,7,183
88,66,81,77,38,350
85,69,69,47,33,303
42,23,80,42,74,261
47,33,71,3,51,205
57,33,32,95,38,255
21,94,8,63,85,271
51,90,98,15,90,344
24,61,27,46,65,223
6,95,75,83,43,302
5,49,42,76,75,247
39,59,33,24,63,218
18,44,88,7,75,232
74,33,96,34,62,299
60,96,100,11,53,320
51,20,5,5,48,129
64,62,6,13,78,223
12,3,100,83,65,263
50,66,34,67,3,220
19,79,44,80,93,315
31,82,37,92,13,255
98,28,47,91,30,294
52,81,56,88,4,281
60,43,75,13,57,248
16,80,97,9,61,263
42,68,56,67,8,241
57,25,58,81,68,289
55,7,18,91,9,180
48,66,45,35,62,256
65,32,67,47,84,295
68,13,35,17,69,202
91,68,12,15,98,284
45,65,47,80,8,245
100,62,45,16,27,250
91,55,39,83,34,302
81,56,78,17,68,300
81,49,97,90,91,408
48,18,30,3,4,103
51,3,84,100,20,258
28,69,21,63,60,241
35,33,27,91,5,191
61,76,73,95,67,372
52,90,46,98,48,334
23,68,73,52,31,247
86,12,40,66,93,297
98,91,61,28,13,291
73,99,53,30,92,347
92,66,64,37,21,280
95,25,59,80,26,285
17,24,22,57,4,124
10,2,40,2,24,78
37,59,99,44,64,303
13,88,46,34,93,274
42,31,94,78,14,259
40,4,83,12,18,157
89,47,59,31,47,273
84,17,72,31,48,252
75,97,81,17,50,320
67,98,87,47,3,302
37,58,37,2,93,227
15,50,86,85,9,245
20,29,63,1,46,159
94,50,40,21,52,257
29,45,65,9,47,195
32,95,26,92,19,264
48,67,43,43,23,224
77,96,7,10,28,218
56,100,23,5,44,228
48,99,62,52,4,265
25,44,52,52,9,182
42,28,18,59,62,209
89,8,69,17,80,263
35,37,90,70,1,233
3,87,71,83,74,318
100,24,63,30,26,243
56,74,49,23,19,221
49,54,92,92,86,373
32,81,22,7,93,235
65,30,43,6,65,209
31,61,76,93,44,305
64,28,88,10,51,241
80,78,90,98,60,406
13,61,17,66,84,241
46,99,8,75,56,284
34,8,20,11,61,134
55,19,50,1,51,176
25,50,71,48,57,251
56,37,79,20,27,219
99,52,99,92,67,409
80,94,94,96,26,390
24,71,9,50,76,230
36,3,32,19,24,114
32,35,58,60,80,265
76,58,24,95,18,271
68,99,54,68,11,300
92,50,69,42,97,350
47,74,17,21,63,222
59,77,15,67,60,278
76,10,40,99,77,302
98,1,64,39,11,213
100,3,87,23,87,300
74,40,28,53,43,238
44,49,53,45,77,268
81,45,93,33,8,260
49,60,57,72,69,307
67,56,21,20,81,245
2,86,32,65,13,198
63,70,9,69,26,237
33,2,92,67,21,215
6,82,100,74,56,318
81,20,96,1,59,257
75,93,72,61,6,307
70,89,64,9,99,331
27,9,44,44,31,155
99,87,72,7,68,333
55,65,20,6,94,240
58,87,15,68,69,297
2,53,50,25,81,211
8,67,59,93,96,323
26,43,36,91,8,204
3,79,2,10,25,119
61,5,95,28,84,273
52,8,41,83,34,218
35,30,40,15,6,126
66,15,20,71,28,200
9,83,78,23,25,218
25,52,66,79,4,226
12,93,31,71,92,299
64,25,49,10,9,157
90,5,4,53,14,166
22,58,54,83,60,277
61,28,6,88,100,283
23,16,74,62,80,255
11,84,10,53,98,256
22,52,50,45,37,206
94,34,47,71,5,251
10,78,22,30,1,141
90,58,55,42,34,279
51,75,89,94,80,389
98,94,47,12,90,341
98,4,30,68,35,235
24,17,79,7,94,221
39,42,22,87,23,213
45,74,57,13,40,229
36,45,81,99,41,302
29,28,80,74,46,257
84,64,66,62,27,303
32,26,74,77,20,229
51,98,20,6,2,177
44,93,63,2,7,209
99,6,61,89,17,272
55,73,37,71,81,317
25,2,3,90,8,128
58,31,91,2,43,225
49,72,86,22,78,307
64,72,81,8,51,276
39,93,84,24,90,330
55,41,44,36,43,219
24,86,61,62,5,238
15,78,88,41,16,238
43,71,81,3,26,224
7,28,17,43,84,179
64,5,44,1,71,185
44,74,73,59,27,277
84,76,82,48,72,362
16,30,64,49,43,202
78,79,49,59,17,282
61,86,5,20,69,241
51,98,77,15,42,283
90,71,79,48,14,302
6,59,16,18,73,172
84,58,71,41,85,339
72,61,43,97,53,326
95,80,76,34,71,356
61,62,44,32,23,222
57,80,31,10,82,260
41,97,30,77,95,340
8,94,75,69,100,346
52,10,46,97,21,226
45,84,15,28,50,222
24,12,60,45,1,142
2,42,83,55,51,233
7,72,98,48,66,291
17,79,92,77,19,284
62,35,72,60,23,252
27,93,97,36,32,285
41,49,50,37,40,217
63,91,44,38,40,276
64,2,10,63,15,154
44,10,69,12,69,204
34,42,54,55,70,255
25,49,45,78,44,241
45,92,77,59,56,329
15,47,55,75,22,214
65,59,61,23,11,219
35,76,100,90,16,317
30,27,59,33,4,153
77,87,45,91,94,394
15,7,45,6,75,148
98,3,61,15,74,251
58,93,65,54,62,332
30,11,41,69,37,188
1,2,26,83,63,175
3,82,76,18,68,247
100,63,28,45,11,247
55,1,18,89,49,212
11,43,45,57,22,178
46,30,21,69,68,234
18,80,3,75,86,262
42,64,49,53,62,270
47,54,91,13,67,272
17,68,12,19,52,168
31,35,35,49,33,183
55,23,28,33,33,172
7,68,19,65,92,251
60,8,33,65,52,218
9,7,46,31,73,166
21,85,46,86,67,305
63,85,44,79,55,326
26,28,84,98,19,255
60,37,96,3,39,235
4,35,52,4,53,148
5,44,70,39,56,214
40,11,41,11,72,175
58,35,58,29,95,275
67,61,58,49,39,274
41,88,91,60,1,281
38,84,73,82,58,335
50,69,8,56,89,272
39,25,68,80,36,248
50,6,43,41,33,173
3,22,42,96,95,258
60,7,79,77,31,254
38,90,34,60,1,223
13,86,55,30,52,236
13,32,33,43,31,152
9,49,48,60,6,172
83,28,75,44,53,283
68,23,39,49,78,257
68,43,46,1,93,251
95,36,38,63,72,304
60,69,21,27,46,223
39,91,38,34,9,211
7,9,65,38,9,128
11,13,12,58,9,103
45,75,3,36,57,216
33,27,33,4,28,125
99,90,70,47,69,375
96,86,77,57,18,334
82,88,61,86,60,377
43,65,86,84,70,348
86,43,72,8,49,258
25,25,97,84,71,302
54,13,49,39,98,253
44,16,60,57,75,252
63,51,69,18,77,278
20,9,8,72,83,192
40,27,53,48,23,191
46,69,64,46,85,310
89,5,57,69,11,231
94,24,90,2,32,242
39,85,55,62,22,263
69,89,30,31,24,243
17,35,10,68,96,226
70,81,88,30,98,367
41,34,46,91,38,250
30,16,53,100,24,223
71,97,91,77,59,395
90,93,94,84,18,379
24,65,87,60,78,314
78,90,37,31,27,263
34,93,17,6,84,234
71,18,1,41,89,220
58,13,81,63,81,296
57,30,62,43,67,259
25,81,62,96,29,293
45,34,17,62,29,187
100,60,23,36,9,228
1,6,96,98,86,287
2,50,44,84,71,251
34,74,50,40,27,225
5,85,99,62,77,328
53,70,23,58,17,221
88,62,61,70,89,370
8,91,4,14,12,129
43,45,91,64,83,326
74,89,27,51,7,248
24,65,83,38,61,271
90,48,94,94,75,401
72,29,60,32,6,199
42,96,52,51,78,319
59,51,54,60,35,259
69,68,43,63,4,247
30,58,99,94,78,359
66,87,83,63,89,388
54,67,81,30,43,275
67,58,58,29,98,310
24,34,58,68,56,240
31,23,32,9,54,149
83,15,3,9,96,206
23,72,64,79,58,296
53,31,13,7,95,199
95,20,62,80,68,325
11,55,22,23,96,207
13,15,4,62,25,119
50,15,48,66,60,239
71,80,81,94,55,381
5,84,32,29,74,224
82,42,22,51,91,288
35,76,27,92,38,268
10,94,41,3,45,193
95,25,49,70,50,289
36,24,7,48,31,146
45,93,9,41,24,212
34,51,10,45,71,211
87,12,64,69,22,254
77,89,61,70,70,367
98,22,71,92,84,367
71,97,8,83,62,321
75,99,75,19,19,287
74,45,92,74,87,372
47,41,22,39,40,189
90,39,94,90,92,405
46,51,5,19,91,212
82,26,85,76,94,363
54,79,42,21,49,245
14,81,57,16,71,239
76,39,56,4,93,268
52,60,81,49,13,255
35,94,47,19,36,231
2,60,77,25,58,222
47,8,85,56,40,236
69,10,83,41,33,236
64,33,18,6,8,129
98,81,38,12,80,309
14,1,64,5,58,142
60,6,36,32,55,189
83,27,10,51,36,207
5,33,63,10,98,209
22,16,12,51,47,148
44,45,59,72,92,312
34,4,61,13,7,119
89,49,96,22,98,354
6,9,73,98,36,222
98,60,78,88,100,424
21,76,58,63,86,304
31,85,22,28,2,168
85,35,10,78,45,253
67,30,76,59,61,293
9,74,22,48,39,192
20,35,26,1,37,119
17,5,90,67,10,189
74,14,83,54,69,294
47,67,78,29,73,294
94,26,40,31,25,216
76,81,1,9,92,259
37,10,3,12,29,91
53,14,81,35,18,201
38,91,80,66,39,314
77,57,51,63,79,327
63,84,86,83,47,363
44,19,45,60,59,227
92,86,5,7,36,226
53,89,4,70,85,301
23,38,12,39,31,143
65,15,7,79,42,208
45,64,98,11,50,268
49,31,5,94,8,187
94,47,30,58,22,251
49,53,32,34,42,210
97,4,55,73,21,250
3,67,10,16,28,124
40,96,41,21,10,208
36,21,81,48,100,286
60,91,65,35,52,303
45,54,24,43,15,181
14,68,5,25,23,135
92,77,85,54,92,400
64,100,11,9,54,238
36,34,5,50,65,190
81,89,10,52,77,309
28,10,47,83,12,180
16,68,28,55,70,237
30,91,39,100,95,355
31,56,33,56,64,240
82,26,82,21,89,300
13,21,48,44,49,175
95,89,70,39,94,387
2,78,3,9,73,165
13,82,70,12,92,269
69,6,27,46,4,152
20,26,17,12,82,157
35,52,16,1,35,139
89,41,18,79,64,291
85,87,19,39,58,288
87,59,6,98,36,286
15,76,62,26,75,254
89,38,22,14,5,168
84,59,93,51,97,384
99,93,4,26,7,229
46,7,36,6,64,159
63,57,76,48,21,265
45,20,9,65,3,142
15,59,88,40,35,237
6,87,59,55,31,238
90,21,7,64,75,257
29,67,17,84,6,203
33,93,37,67,84,314
48,96,45,8,84,281
49,81,18,89,69,306
38,4,28,88,92,250
100,87,2,60,70,319
9,6,92,67,68,242
86,2,63,44,69,264
10,87,67,14,29,207
54,15,6,95,73,243
24,69,1,44,76,214
37,37,29,39,24,166
35,55,57,40,88,275
1,7,73,30,27,138
60,60,94,73,20,307
79,47,66,69,51,312
46,88,6,80,92,312
31,7,11,13,64,126
8,16,88,76,40,228
86,35,61,51,43,276
25,11,28,70,63,197
57,8,67,34,44,210
14,90,59,24,73,260
2,62,94,78,45,281
65,33,8,13,71,190
13,1,11,42,84,151
37,68,20,93,38,256
10,81,81,19,52,243
33,52,60,71,70,286
27,88,9,74,84,282
42,41,66,69,69,287
97,96,51,18,76,338
26,71,61,4,22,184
89,58,41,33,40,261
23,67,35,97,20,242
77,30,53,51,49,260
48,8,60,29,49,194
14,68,61,72,8,223
72,12,84,39,36,243
87,58,49,73,73,340
3,71,69,53,93,289
39,88,48,2,23,200
79,80,37,25,18,239
86,54,14,99,89,342
30,18,95,15,81,239
44,5,91,27,82,249
62,99,47,94,62,364
3,64,49,15,2,133
55,76,59,94,76,360
25,19,66,42,28,180
88,3,100,79,23,293
60,23,40,43,71,237
41,9,1,100,37,188
97,34,10,21,98,260
29,96,96,5,55,281
47,25,87,47,64,270
61,73,31,24,92,281
48,40,53,18,62,221
25,95,76,84,18,298
16,63,10,5,9,103
97,6,2,9,31,145
70,40,22,44,28,204
53,27,11,34,20,145
74,38,62,66,90,330
57,13,33,8,97,208
91,4,66,17,32,210
81,37,14,29,89,250
21,16,37,41,7,122
24,15,27,73,35,174
38,92,7,70,84,291
82,7,69,37,18,213
53,92,61,34,47,287
50,12,84,75,49,270
51,7,83,52,50,243
42,7,17,2,24,92
22,37,18,67,91,235
1,66,1,41,50,159
82,62,7,97,13,261
69,45,97,28,96,335
1,83,7,4,82,177
76,74,92,22,28,292
79,74,93,46,3,295
13,97,72,57,3,242
92,3,47,27,67,236
87,25,25,53,48,238
72,26,93,99,90,380
19,25,92,31,43,210
73,21,58,54,77,283
57,71,16,80,15,239
37,59,25,38,13,172
7,85,57,46,64,259
37,67,91,48,73,316
9,47,67,16,19,158
25,72,56,46,14,213
77,23,89,49,73,311
10,27,39,9,56,141
81,36,25,86,87,315
79,3,96,67,55,300
97,67,81,30,48,323
36,18,100,61,67,282
34,84,88,9,45,260
11,13,43,24,10,101
99,72,22,43,25,261
92,5,87,18,37,239
24,19,89,10,8,150
36,18,53,72,82,261
9,60,65,99,43,276
88,91,7,41,41,268
74,87,9,4,79,253
35,22,22,31,17,127
94,99,72,69,45,379
18,82,16,27,7,150
21,95,87,50,36,289
56,41,19,62,39,217
15,76,74,67,77,309
37,78,76,60,33,284
34,27,40,96,53,250
83,55,49,12,8,207
37,54,29,5,10,135
100,42,43,56,34,275
94,71,57,9,75,306
35,30,54,67,23,209
41,79,41,73,41,275
62,79,23,68,85,317
30,38,81,75,31,255
73,94,4,13,28,212
21,42,100,91,33,287
73,43,65,14,95,290
10,48,79,68,13,218
73,58,66,52,60,309
29,86,53,52,88,308
15,35,57,71,67,245
31,5,96,20,1,153
4,50,25,51,82,212
2,14,52,35,11,114
37,74,12,26,45,194
38,27,92,72,1,230
96,65,89,20,74,344
86,56,59,58,7,266
52,42,100,95,85,374
64,21,2,49,22,158
42,1,77,55,17,192
20,58,4,60,79,221
20,68,1,93,19,201
34,22,88,100,13,257
98,23,33,78,30,262
60,47,96,20,56,279
61,93,64,60,89,367
23,58,83,91,32,287
55,1,83,59,74,272
42,83,44,90,62,321
25,26,36,4,40,131
41,56,71,66,56,290
74,9,66,94,80,323
50,68,95,97,2,312
12,75,51,45,85,268
91,58,46,43,23,261
46,45,69,40,98,298
55,84,57,24,77,297
34,94,34,42,48,252
9,26,62,66,35,198
90,97,78,93,36,394
39,26,18,93,18,194
79,68,41,65,89,342
43,31,27,38,29,168
36,75,62,66,70,309
26,16,14,66,73,195
63,47,17,31,19,177
27,50,62,77,73,289
3,31,58,27,94,213
71,20,84,73,32,280
45,38,73,43,8,207
95,44,31,25,62,257
86,84,70,57,83,380
20,54,12,18,40,144
42,97,6,29,7,181
22,12,50,70,69,223
10,28,75,57,6,176
53,46,94,85,59,337
41,90,78,10,51,270
7,3,44,78,22,154
54,92,44,100,60,350
46,60,54,30,40,230
13,86,48,52,30,229
47,98,77,12,89,323
59,17,63,69,89,297
39,87,31,31,89,277
86,23,85,94,79,367
97,90,24,20,75,306
36,2,28,47,95,208
98,92,80,71,17,358
92,49,57,79,61,338
62,34,52,92,68,308
45,78,18,75,83,299
67,39,86,100,2,294
79,99,80,9,2,269
22,68,56,97,38,281
74,40,14,30,44,202
3,57,13,60,34,167
66,20,41,39,73,239
12,45,20,36,43,156
36,52,73,60,9,230
4,95,64,59,69,291
55,98,88,29,26,296
50,52,14,3,11,130
21,19,23,50,41,154
60,78,15,77,23,253
10,84,79,75,83,331
22,87,2,25,35,171
94,67,58,49,78,346
87,26,6,47,94,260
30,2,35,51,53,171
50,9,17,73,44,193
4,1,8,14,34,61
73,85,2,87,89,336
64,46,60,61,77,308
80,80,38,42,87,327
79,87,73,35,96,370
87,27,62,11,52,239
58,39,45,47,92,281
39,11,9,76,21,156
83,60,8,21,94,266
8,26,4,63,21,122
20,35,34,61,80,230
80,68,25,28,79,280
87,100,54,69,58,368
89,72,78,91,69,399
29,85,45,34,91,284
2,39,64,40,14,159
58,99,63,9,38,267
39,51,98,12,52,252
56,89,89,36,75,345
25,5,10,39,89,168
26,93,10,34,71,234
76,19,33,50,79,257
16,31,15,59,65,186
53,24,64,27,78,246
24,25,96,82,85,312
34,29,40,7,99,209
78,27,76,64,83,328
46,19,64,99,97,325
39,14,6,99,73,231
42,75,42,54,68,281
8,53,98,57,51,267
31,12,19,79,84,225
41,95,82,20,54,292
63,4,11,93,70,241
81,12,63,81,51,288
49,66,60,42,33,250
40,67,39,35,13,194
51,57,6,74,39,227
87,39,60,99,3,288
4,20,15,90,12,141
11,94,84,69,25,283
30,37,19,49,3,138
24,56,10,60,41,191
38,15,89,54,35,231
94,38,37,82,77,328
25,18,39,27,35,144
73,19,44,26,100,262
35,74,93,12,54,268
14,76,44,19,79,232
94,70,22,29,89,304
77,1,86,56,5,225
76,9,38,88,5,216
20,36,87,5,37,185
91,46,91,63,39,330
10,54,78,66,96,304
94,70,48,7,66,285
96,41,21,40,21,219
72,75,38,32,93,310
98,94,10,2,45,249
97,57,65,40,62,321
31,1,93,33,73,231
28,28,86,7,23,172
100,83,51,21,59,314
82,89,89,7,79,346
19,80,57,97,54,307
92,51,89,39,78,349
27,91,90,34,71,313
92,98,51,73,56,370
12,52,87,89,64,304
70,85,22,57,60,294
34,85,49,99,95,362
99,66,76,25,26,292
21,75,16,91,41,244
83,92,34,95,77,381
36,42,27,47,64,216
78,72,52,12,87,301
59,54,41,72,99,325
1,78,67,74,72,292
39,38,32,93,71,273
65,83,74,95,52,369
99,4,65,18,74,260
64,96,21,44,78,303
45,93,45,50,46,279
5,89,57,5,5,161
24,85,10,63,80,262
23,54,58,35,42,212
56,78,20,28,100,282
58,97,93,8,60,316
95,99,46,91,63,394
22,100,59,89,44,314
38,89,57,8,24,216
89,2,1,100,73,265
76,91,61,15,40,283
38,52,43,46,2,181
41,26,95,24,17,203
79,70,97,44,6,296
14,19,43,15,81,172
95,31,99,22,2,249
42,82,84,2,19,229
19,10,29,94,68,220
60,80,55,33,100,328
46,15,77,56,55,249
64,26,14,15,63,182
97,91,49,30,95,362
31,66,8,54,65,224
7,59,11,95,53,225
15,77,35,76,16,219
96,84,64,24,97,365
85,67,70,28,64,314
47,46,51,87,21,252
14,3,22,86,43,168
97,84,62,91,44,378
6,13,14,61,12,106
66,73,96,44,56,335
97,10,34,12,59,212
72,86,46,65,12,281
50,68,52,55,66,291
66,83,28,50,88,315
71,57,85,26,41,280
21,54,8,67,11,161
51,65,28,73,15,232
65,94,30,8,25,222
5,78,46,81,41,251
39,81,5,59,17,201
31,32,14,24,39,140
81,25,53,1,79,239
16,60,54,11,65,206
30,17,72,30,13,162
37,53,24,27,2,143
66,16,8,87,37,214
32,77,19,4,58,190
96,23,38,10,94,261
19,94,93,94,44,344
60,28,1,79,76,244
67,78,41,26,21,233
80,39,66,38,71,294
54,13,69,62,80,278
40,54,7,63,40,204
29,36,49,70,97,281
29,65,69,84,60,307
60,59,79,53,67,318
45,88,87,95,4,319
47,19,35,98,34,233
42,95,34,7,91,269
49,80,93,9,17,248
95,72,42,57,75,341
51,25,8,65,51,200
59,19,50,37,41,206
70,53,40,64,79,306
56,48,92,68,48,312
9,2,20,6,28,65
82,66,20,100,19,287
62,26,82,58,7,235
91,46,52,40,89,318
41,16,75,67,59,258
96,4,86,62,23,271
97,38,91,58,99,383
15,77,55,90,83,320
78,64,58,35,61,296
62,62,44,91,100,359
49,82,9,37,99,276
86,19,13,46,53,217
21,27,97,16,69,230
21,14,51,62,65,213
35,10,49,85,47,226
95,71,82,38,29,315
28,29,93,88,98,336
59,7,78,73,44,261
27,80,91,24,77,299
45,91,14,37,93,280
89,82,7,24,88,290
8,76,15,13,16,128
100,96,75,13,80,364
11,50,20,13,93,187
72,86,9,13,13,193
87,24,75,85,17,288
50,32,89,21,33,225
92,2,36,98,22,250
70,57,38,88,37,290
65,73,29,94,52,313
36,47,43,98,40,264
62,100,91,76,84,413
35,52,79,34,64,264
59,94,92,28,84,357
82,30,7,91,19,229
87,72,24,21,88,292
99,99,25,29,35,287
49,67,29,53,12,210
46,20,48,29,21,164
72,5,28,30,58,193
59,59,92,17,35,262
13,42,24,53,77,209
77,95,18,95,78,363
40,91,6,83,3,223
34,45,84,78,78,319
21,44,69,47,24,205
82,16,31,5,3,137
88,1,63,45,80,277
96,7,93,36,24,256
53,49,41,79,85,307
73,52,49,14,27,215
84,17,75,26,96,298
17,6,97,92,60,272
45,74,99,98,54,370
19,78,68,63,13,241
19,86,98,12,60,275
69,43,63,17,23,215
83,55,65,10,48,261
49,45,70,15,51,230
70,17,51,9,55,202
41,66,40,26,12,185
37,94,67,78,19,295
25,85,56,80,6,252
60,36,67,1,80,244
3,54,78,69,51,255
93,94,49,13,37,286
19,81,72,87,19,278
86,45,5,70,5,211
96,36,11,77,96,316
89,81,68,70,72,380
7,91,83,54,44,279
26,24,65,24,80,219
61,34,73,17,40,225
36,58,29,2,79,204
96,75,7,87,51,316
73,26,23,31,56,209
51,31,57,46,18,203
38,78,37,87,66,306
96,8,77,5,46,232
24,5,86,72,77,264
78,62,21,97,38,296
95,49,36,4,17,201
95,14,78,77,12,276
93,38,17,96,56,300
27,14,60,56,42,199
91,90,32,37,75,325
45,95,25,17,84,266
99,19,72,85,22,297
80,67,99,13,27,286
1,96,54,14,29,194
11,90,85,90,15,291
79,5,41,93,58,276
54,30,53,93,14,244
39,31,29,2,50,151
84,47,61,39,92,323
49,16,65,12,83,225
22,8,58,17,92,197
80,49,68,19,99,315
94,30,73,40,10,247
27,34,38,92,92,283
69,37,38,98,78,320
92,8,76,43,10,229
51,65,43,9,27,195
5,21,11,49,97,183
87,20,56,85,84,332
68,2,35,82,82,269
100,22,31,93,35,281
25,49,47,33,30,184
67,96,78,16,17,274
94,16,8,84,33,235
42,37,99,87,62,327
66,36,35,65,67,269
75,30,32,69,88,294
62,71,42,45,40,260
8,92,64,43,68,275
43,7,24,93,22,189
76,42,65,33,77,293
36,98,84,80,12,310
23,39,44,22,41,169
4,31,85,17,75,212
78,52,91,4,11,236
66,43,73,26,47,255
46,60,5,84,8,203
66,88,78,22,2,256
62,85,79,100,16,342
53,65,84,88,92,382
96,94,43,73,73,379
77,66,72,43,98,356
69,84,29,16,100,298
100,27,3,65,15,210
23,18,49,82,11,183
60,67,71,32,56,286
47,46,68,38,90,289
41,81,11,9,7,149
95,59,16,70,14,254
50,24,1,52,88,215
40,49,53,37,12,191
20,45,7,17,43,132
2,59,12,90,15,178
45,11,2,73,54,185
4,71,17,9,13,114
69,10,73,82,73,307
85,87,7,59,1,239
8,99,92,63,54,316
37,80,83,19,87,306
44,71,52,49,45,261
61,14,28,52,35,190
67,1,11,95,97,271
28,48,83,79,47,285
63,12,46,5,78,204
77,49,36,12,93,267
45,39,17,99,5,205
63,88,58,90,83,382
25,51,76,53,30,235
16,31,90,80,41,258
84,27,96,55,97,359
86,20,48,87,15,256
5,54,55,61,74,249
62,59,69,61,99,350
35,75,57,45,68,280
81,63,74,43,82,343
51,36,18,77,89,271
92,34,72,74,79,351
49,8,4,47,16,124
90,58,95,48,29,320
74,50,61,81,44,310
32,78,77,60,93,340
69,54,42,81,79,325
42,48,84,98,25,297
49,55,10,98,42,254
33,56,68,75,45,277
55,31,59,21,10,176
36,71,19,55,83,264
10,22,26,26,90,174
89,94,49,95,55,382
48,46,82,37,58,271
22,39,18,80,32,191
26,64,55,19,91,255
93,70,39,75,57,334
68,15,61,15,28,187
77,79,57,23,79,315
34,49,8,59,20,170
2,82,41,88,74,287
66,93,54,92,51,356
47,64,81,67,76,335
47,56,20,37,48,208
58,3,11,96,81,249
47,68,3,77,59,254
99,76,82,81,63,401
41,39,69,39,33,221
12,36,43,6,3,100
75,35,76,62,58,306
29,19,82,66,29,225
29,78,88,31,80,306
48,6,57,72,93,276
65,13,59,30,17,184
99,58,5,53,82,297
77,60,73,44,32,286
69,46,42,88,46,291
45,31,88,83,6,253
82,33,35,25,41,216
10,9,12,48,68,147
57,39,89,45,71,301
4,50,66,90,60,270
94,10,12,52,17,185
68,35,61,79,21,264
55,30,29,32,18,164
97,19,74,62,51,303
67,99,60,33,48,307
37,38,96,93,4,268
12,98,17,97,98,322
2,93,84,40,51,270
31,50,61,41,61,244
68,30,53,87,81,319
47,9,66,75,97,294
10,51,50,54,54,219
45,66,93,76,73,353
44,8,37,65,12,166
51,25,71,10,1,158
18,18,69,35,32,172
16,3,27,42,14,102
54,65,52,27,41,239
58,35,44,58,31,226
79,37,35,66,73,290
89,66,72,13,88,328
82,54,70,100,41,347
62,94,15,86,20,277
44,58,8,27,51,188
32,2,70,46,50,200
68,3,29,13,77,190
83,36,22,74,85,300
1,42,83,39,25,190
54,45,10,48,41,198
16,68,53,18,26,181
96,89,66,77,73,401
88,16,4,85,74,267
44,81,50,62,96,333
77,41,83,43,73,317
47,3,96,9,54,209
66,32,96,66,56,316
100,26,55,62,54,297
67,31,36,62,7,203
73,75,17,97,29,291
9,83,85,64,1,242
51,21,19,40,22,153
77,4,14,83,90,268
27,91,23,30,57,228
29,5,17,97,1,149
24,74,44,55,93,290
29,16,86,61,47,239
3,46,29,30,63,171
49,9,82,30,97,267
93,19,48,21,79,260
89,6,82,40,97,314
31,89,67,11,39,237
49,20,93,3,90,255
20,20,72,18,67,197
30,91,65,50,79,315
4,1,13,30,5,53
67,70,22,47,56,262
91,74,53,67,53,338
35,8,58,33,31,165
93,64,97,75,77,406
30,75,52,72,31,260
43,58,100,67,71,339
9,5,77,30,1,122
75,57,87,32,81,332
94,85,5,96,99,379
85,38,81,49,8,261
35,79,38,65,1,218
73,42,52,55,50,272
36,13,9,69,39,166
94,15,56,61,76,302
52,34,1,65,21,173
6,42,14,14,30,106
58,45,76,16,22,217
48,18,48,37,69,220
78,30,17,64,26,215
63,96,26,18,88,291
6,59,76,12,5,158
52,2,28,64,82,228
57,28,28,84,93,290
72,57,89,1,16,235
3,1,86,38,67,195
85,62,59,54,53,313
46,52,51,79,87,315
96,16,67,45,39,263
97,77,61,38,82,355
10,87,95,30,5,227
44,42,42,45,42,215
96,70,82,79,82,409
7,24,64,23,52,170
81,72,73,32,10,268
96,40,87,20,39,282
79,91,28,66,84,348
79,55,37,34,13,218
94,51,86,65,91,387
31,84,38,22,95,270
27,48,23,62,97,257
42,97,50,93,11,293
99,94,74,58,25,350
57,42,9,51,88,247
49,76,98,32,81,336
69,30,2,61,34,196
43,2,64,17,59,185
94,81,100,62,52,389
41,29,67,77,15,229
40,1,34,17,40,132
64,84,70,12,90,320
55,20,40,89,30,234
63,89,31,92,9,284
29,28,43,71,65,236
12,79,84,16,52,243
46,64,7,35,60,212
73,40,77,43,57,290
39,60,4,6,96,205
80,62,48,64,92,346
88,52,90,2,48,280
69,36,97,80,13,295
11,47,6,3,91,158
8,1,30,64,63,166
72,11,53,61,41,238
89,7,9,29,81,215
13,79,96,22,96,306
88,10,44,73,72,287
34,45,34,79,30,222
97,30,51,63,53,294
32,25,99,14,53,223
41,40,12,5,60,158
17,82,14,83,77,273
20,7,79,18,4,128
48,100,30,35,85,298
14,39,8,67,54,182
7,83,99,39,29,257
49,1,42,7,25,124
93,12,35,86,87,313
34,80,37,98,76,325
67,33,58,77,87,322
94,44,2,18,74,232
56,84,54,39,54,287
88,73,43,26,10,240
2,39,80,12,48,181
11,93,43,17,64,228
55,97,47,41,90,330
72,71,55,37,30,265
10,17,35,75,42,179
17,98,94,44,97,350
59,56,84,82,15,296
63,24,84,70,68,309
37,39,93,59,27,255
100,5,6,90,93,294
81,28,2,46,78,235
75,62,23,86,55,301
1,26,88,57,71,243
64,66,10,42,22,204
42,67,18,22,53,202
61,34,3,24,4,126
27,36,47,8,45,163
35,17,94,37,95,278
17,40,56,79,8,200
51,85,2,28,74,240
87,34,41,7,84,253
29,30,44,95,9,207
65,14,74,16,23,192
79,88,67,41,57,332
99,51,84,96,60,390
34,39,65,56,25,219
33,71,68,41,34,247
59,26,5,95,77,262
15,4,95,50,55,219
92,97,69,73,73,404
40,2,5,3,73,123
67,20,66,2,48,203
81,74,60,78,100,393
57,88,46,55,32,278
10,53,83,82,82,310
83,26,30,59,89,287
55,27,73,73,63,291
14,93,37,92,37,273
68,75,75,67,58,343
86,35,1,48,8,178
68,31,17,76,38,230
96,13,54,17,25,205
41,3,33,96,37,210
46,33,28,33,47,187
38,24,24,20,15,121
6,55,8,27,2,98
1,46,48,97,29,221
74,9,15,54,35,187
55,62,19,80,3,219
23,36,55,18,80,212
71,78,42,71,12,274
25,80,39,52,60,256
97,77,74,65,89,402
76,49,8,2,91,226
24,90,85,85,9,293
38,79,84,42,81,324
62,24,8,27,93,214
86,95,47,13,31,272
1,74,86,61,10,232
46,24,56,76,60,262
38,29,27,100,50,244
91,75,93,52,1,312
89,53,17,73,5,237
91,74,24,42,11,242
55,78,14,59,69,275
13,65,52,51,88,269
2,66,98,75,27,268
23,93,93,62,28,299
41,26,80,51,3,201
84,64,6,91,58,303
80,35,75,29,75,294
58,97,30,54,12,251
14,59,10,31,54,168
92,62,18,88,59,319
85,18,55,40,3,201
11,28,81,14,6,140
44,7,60,94,10,215
53,46,54,43,92,288
69,59,12,36,37,213
57,19,57,71,98,302
74,33,88,61,80,336
49,66,56,51,25,247
94,67,89,21,24,295
30,60,48,82,46,266
32,32,34,3,46,147
18,44,25,20,14,121
2,91,85,65,28,271
85,28,39,74,62,288
44,5,55,49,23,176
98,83,94,53,52,380
55,40,64,76,53,288
26,55,65,48,88,282
48,38,10,88,39,223
52,5,60,37,41,195
81,91,91,96,79,438
16,3,17,42,19,97
16,82,8,90,58,254
68,36,63,56,61,284
99,38,20,47,8,212
47,84,36,54,81,302
61,81,19,13,71,245
81,31,8,45,83,248
24,44,55,55,26,204
26,26,70,34,26,182
100,91,76,6,3,276
75,8,48,57,43,231
54,67,40,93,85,339
98,22,45,99,92,356
46,35,32,49,95,257
62,3,52,15,65,197
5,38,47,93,73,256
19,5,19,78,91,212
65,94,45,27,28,259
16,81,77,75,84,333
38,68,60,77,80,323
50,38,34,62,2,186
28,26,57,35,5,151
30,16,79,97,81,303
35,34,18,38,65,190
83,88,71,74,82,398
9,26,20,62,41,158
45,14,88,66,95,308
100,14,35,63,56,268
51,23,10,90,78,252
27,18,98,8,87,238
54,89,23,14,45,225
28,20,39,64,96,247
17,90,46,62,56,271
51,54,87,99,10,301
79,41,65,20,70,275
18,68,99,91,41,317
82,37,8,27,100,254
8,86,61,77,2,234
61,51,60,71,36,279
90,13,46,68,43,260
72,98,85,16,41,312
80,95,94,15,78,362
82,35,69,35,68,289
8,45,59,24,28,164
36,88,92,76,4,296
30,37,51,52,31,201
87,84,30,45,28,274
45,49,57,22,2,175
87,50,29,42,27,235
37,34,69,46,36,222
89,38,52,75,49,303
75,26,72,28,67,268
48,36,44,50,56,234
78,41,73,57,20,269
58,66,85,35,56,300
57,13,56,42,50,218
84,77,5,48,96,310
75,7,13,75,42,212
45,87,45,34,15,226
93,27,39,80,90,329
1,39,30,48,95,213
34,24,29,3,100,190
97,50,40,93,67,347
25,51,61,88,59,284
86,98,50,8,75,317
71,92,6,92,42,303
29,81,49,91,57,307
73,87,67,11,72,310
52,82,98,52,59,343
49,91,60,7,53,260
71,63,75,31,60,300
10,71,81,85,93,340
71,71,28,78,12,260
56,60,84,34,26,260
90,48,72,37,90,337
57,49,97,18,98,319
68,58,33,5,52,216
28,39,23,27,59,176
53,92,81,20,95,341
7,21,47,99,29,203
99,65,31,72,85,352
18,34,30,89,8,179
7,64,100,67,70,308
73,77,36,67,45,298
72,86,93,28,96,375
49,19,71,11,89,239
60,63,52,83,26,284
25,36,51,61,97,270
40,38,26,54,77,235
24,47,43,81,99,294
71,78,45,86,86,366
51,87,7,93,12,250
67,32,6,93,95,293
58,89,83,71,33,334
43,19,92,4,87,245
75,92,32,21,25,245
43,55,53,33,59,243
11,50,60,45,29,195
94,65,61,85,25,330
47,71,28,77,89,312
53,60,98,90,31,332
85,9,33,48,66,241
28,19,12,65,50,174
87,21,57,82,25,272
55,93,94,85,69,396
4,33,14,67,43,161
55,27,87,23,15,207
98,61,79,47,26,311
93,48,73,24,24,262
14,76,19,58,31,198
84,45,63,48,21,261
83,91,1,6,45,226
66,34,91,99,67,357
93,53,96,69,48,359
57,61,52,24,24,218
51,45,75,82,19,272
91,62,92,43,100,388
70,10,22,47,47,196
16,98,89,63,54,320
54,89,41,90,91,365
75,97,66,64,34,336
4,56,99,57,30,246
32,12,8,85,66,203
62,31,23,39,3,158
52,79,66,22,6,225
1,70,66,58,54,249
56,74,50,37,58,275
6,51,49,56,83,245
44,88,83,83,7,305
70,87,3,44,13,217
33,2,86,56,29,206
70,82,20,37,12,221
89,26,22,76,4,217
59,67,97,90,70,383
73,58,52,62,25,270
33,48,30,92,33,236
48,53,33,12,7,153
6,85,8,19,37,155
18,59,96,9,35,217
59,73,21,63,5,221
79,20,64,53,75,291
65,89,75,85,55,369
94,75,97,56,31,353
64,97,97,15,82,355
86,77,46,43,35,287
29,18,9,61,6,123
42,33,10,8,2,95
13,55,7,51,79,205
97,98,92,21,37,345
67,19,66,31,81,264
94,78,30,50,12,264
59,21,4,54,14,152
11,89,75,58,90,323
62,4,92,79,65,302
25,100,53,71,77,326
50,66,27,24,77,244
2,63,96,13,85,259
84,70,23,73,94,344
45,62,43,53,2,205
16,53,20,77,36,202
98,5,28,81,99,311
6,52,69,97,59,283
68,49,13,48,87,265
47,18,74,30,61,230
93,64,83,88,68,396
70,18,74,19,27,208
80,10,100,58,56,304
60,13,31,63,88,255
97,73,18,54,71,313
41,52,11,43,6,153
23,42,19,79,30,193
50,48,55,71,14,238
45,58,12,44,14,173
89,13,24,60,80,266
40,74,15,31,18,178
94,96,18,48,95,351
51,85,89,66,21,312
86,14,92,97,16,305
37,1,93,98,47,276
10,62,21,24,65,182
39,39,17,92,12,199
91,29,52,94,20,286
91,30,28,44,61,254
7,85,11,20,74,197
47,38,50,17,30,182
33,45,81,18,5,182
84,72,83,85,100,424
1,100,73,90,42,306
16,19,54,20,22,131
10,71,90,3,1,175
8,20,76,87,29,220
23,60,28,94,100,305
1,82,91,87,96,357
45,58,69,48,59,279
6,9,98,14,68,195
6,85,74,2,21,188
29,8,23,63,29,152
5,39,91,58,26,219
74,95,81,98,70,418
45,26,10,34,20,135
29,3,22,17,27,98
7,59,64,3,89,222
75,77,4,86,7,249
81,60,31,72,80,324
45,34,1,70,87,237
54,47,63,54,65,283
85,42,14,1,53,195
96,14,15,70,64,259
62,8,86,35,30,221
83,41,18,7,73,222
90,67,12,50,97,316
40,30,6,37,41,154
21,21,2,45,100,189
26,70,46,39,56,237
80,77,45,8,65,275
42,19,77,42,4,184
16,49,47,17,13,142
12,15,100,3,91,221
58,83,76,9,7,233
33,16,43,73,26,191
55,12,70,66,21,224
100,34,39,80,90,343
30,47,89,38,12,216
1,78,68,85,65,297
97,19,67,69,98,350
28,42,42,86,23,221
58,14,53,15,23,163
70,27,35,60,4,196
57,56,52,52,58,275
23,5,95,88,81,292
25,19,45,77,12,178
14,44,45,53,77,233
3,58,61,69,36,227
28,56,76,50,89,299
2,100,32,95,57,286
42,99,16,37,87,281
57,83,1,18,17,176
81,58,44,12,50,245
18,100,52,46,62,278
51,30,100,10,93,284
14,89,96,5,92,296
33,70,4,4,27,138
51,29,17,67,11,175
22,77,32,97,51,279
26,74,31,24,17,172
35,23,4,88,31,181
76,55,74,10,7,222
64,11,2,42,93,212
93,85,78,48,5,309
72,88,98,64,84,406
58,81,27,26,59,251
29,48,91,16,2,186
37,97,58,51,39,282
12,68,3,42,84,209
13,28,44,11,11,107
56,82,92,54,55,339
34,59,39,59,38,229
78,60,44,92,75,349
21,7,28,78,88,222
49,35,17,61,68,230
8,21,44,70,60,203
56,16,21,29,55,177
47,38,66,71,42,264
16,86,90,73,21,286
72,94,83,58,50,357
64,73,12,88,100,337
73,40,76,29,80,298
40,46,19,6,56,167
69,17,7,69,66,228
86,68,98,48,42,342
35,4,23,14,67,143
100,22,67,54,59,302
56,82,49,31,86,304
84,96,84,28,56,348
44,44,67,2,63,220
46,8,60,35,31,180
44,24,40,19,26,153
42,36,45,68,72,263
74,48,41,73,42,278
83,37,88,60,49,317
15,28,79,3,84,209
38,46,26,3,90,203
33,59,1,91,99,283
14,92,9,38,79,232
56,14,7,21,31,129
35,16,74,9,71,205
45,99,36,37,76,293
10,12,97,61,65,245
59,79,81,39,44,302
47,45,5,99,1,197
31,75,64,74,70,314
70,11,95,68,24,268
72,45,84,48,45,294
98,45,23,12,62,240
63,6,34,93,34,230
27,9,72,80,51,239
31,9,87,40,29,196
56,65,25,2,76,224
60,77,12,61,24,234
79,58,99,31,54,321
33,36,15,36,2,122
83,66,93,38,55,335
26,73,23,53,26,201
1,44,27,12,50,134
62,77,4,85,60,288
44,73,18,68,91,294
94,42,26,43,91,296
64,43,9,38,62,216
42,53,95,4,15,209
52,98,95,40,4,289
99,57,79,86,97,418
60,57,38,51,7,213
83,7,65,62,55,272
78,47,61,73,70,329
87,57,34,8,19,205
86,21,28,65,38,238
75,84,92,63,49,363
79,65,46,96,96,382
47,13,96,52,6,214
16,45,48,74,70,253
17,62,37,93,9,218
43,93,73,84,14,307
97,82,45,58,11,293
72,98,5,54,28,257
37,27,59,6,3,132
41,95,45,16,78,275
29,76,91,84,58,338
78,87,9,7,47,228
72,8,21,49,91,241
28,3,63,10,28,132
85,89,99,75,2,350
67,12,18,54,33,184
20,79,55,98,80,332
56,95,7,30,90,278
47,55,71,37,53,263
86,55,75,86,28,330
2,97,30,8,18,155
4,33,29,62,73,201
47,64,70,54,27,262
14,51,22,80,7,174
8,39,1,73,79,200
93,91,78,84,81,427
12,90,78,32,92,304
19,85,69,41,42,256
73,11,69,16,94,263
56,97,14,7,75,249
93,33,46,57,89,318
90,21,11,99,97,318
17,36,17,76,58,204
16,14,9,57,50,146
5,41,17,39,82,184
17,85,97,38,40,277
44,25,51,62,52,234
49,56,16,92,94,307
57,93,88,68,83,389
92,50,44,76,88,350
18,27,66,15,11,137
66,31,72,67,7,243
56,48,48,80,22,254
16,6,16,60,16,114
49,29,57,42,82,259
66,16,46,52,90,270
55,81,89,98,44,367
59,52,74,9,98,292
25,86,91,87,73,362
37,70,42,4,44,197
74,43,49,77,96,339
85,61,87,51,94,378
58,30,20,33,35,176
39,91,88,11,1,230
80,23,48,72,76,299
54,93,74,96,41,358
74,33,94,74,34,309
89,58,99,32,18,296
92,7,13,68,67,247
3,57,61,45,73,239
28,98,50,3,3,182
78,20,94,62,86,340
25,78,71,48,61,283
25,75,9,43,58,210
96,58,78,84,75,391
89,55,55,54,22,275
27,70,41,16,9,163
93,73,7,52,23,248
69,94,55,39,29,286
66,32,54,71,76,299
53,25,99,67,84,328
65,53,45,5,57,225
18,46,88,94,5,251
46,61,28,54,62,251
7,45,20,22,4,98
74,16,89,40,73,292
8,46,66,64,67,251
95,9,61,83,27,275
5,22,54,84,6,171
14,78,60,94,65,311
3,19,56,65,87,230
79,16,36,97,19,247
16,64,96,64,48,288
54,26,96,59,68,303
46,49,16,80,93,284
57,31,14,25,73,200
54,61,88,20,38,261
8,5,68,40,5,126
30,73,78,66,87,334
20,94,81,51,82,328
53,99,90,11,20,273
50,16,41,19,21,147
62,27,48,27,36,200
27,73,50,79,62,291
94,58,39,35,84,310
71,61,21,44,35,232
21,46,7,18,21,113
18,12,73,30,48,181
45,28,16,52,9,150
43,8,95,46,81,273
99,84,25,70,44,322
95,41,29,24,11,200
58,78,22,34,37,229
60,14,28,97,64,263
6,21,92,38,57,214
36,7,86,31,43,203
88,68,40,52,41,289
88,55,87,55,82,367
93,9,80,37,82,301
39,44,83,87,96,349
37,18,1,67,47,170
84,7,32,52,72,247
74,16,16,14,51,171
83,49,97,80,90,399
51,39,65,66,66,287
52,32,6,16,38,144
91,41,6,15,4,157
18,39,83,93,45,278
99,76,59,9,74,317
54,59,43,77,63,296
25,89,10,92,54,270
89,74,37,20,42,262
54,98,70,61,15,298
49,80,20,7,61,217
19,36,96,45,60,256
28,96,99,14,50,287
3,36,13,58,81,191
64,100,34,53,44,295
58,55,12,7,61,193
61,95,46,46,28,276
67,87,64,43,26,287
14,12,71,32,99,228
63,10,2,46,42,163
61,42,78,25,70,276
64,9,48,66,10,197
47,3,87,33,75,245
49,42,78,73,30,272
39,50,29,76,59,253
84,24,76,29,94,307
13,100,62,89,2,266
80,54,23,37,45,239
22,44,80,6,40,192
29,90,33,95,65,312
86,57,54,18,97,312
55,16,11,4,18,104
4,52,97,40,60,253
41,56,62,31,34,224
43,43,85,98,28,297
67,98,8,22,35,230
38,96,39,42,83,298
19,68,1,93,58,239
24,91,18,100,32,265
47,83,79,46,93,348
36,54,15,19,95,219
18,10,68,3,14,113
85,76,22,64,81,328
80,84,92,13,43,312
63,13,5,79,70,230
3,82,60,32,88,265
58,60,61,88,99,366
96,21,67,97,88,369
74,81,6,37,64,262
19,10,52,70,74,225
73,2,84,42,75,276
81,96,46,94,3,320
76,94,87,100,52,409
66,69,42,85,52,314
35,41,38,4,54,172
38,3,17,5,29,92
72,64,71,69,92,368
65,26,23,56,69,239
87,79,36,77,93,372
12,3,57,2,17,91
95,33,76,55,72,331
50,79,16,51,31,227
59,76,76,79,6,296
2,12,32,62,8,116
7,96,100,42,35,280
76,50,39,31,91,287
16,18,93,39,15,181
23,17,55,6,60,161
3,69,76,68,44,260
49,46,90,85,48,318
52,30,92,56,44,274
31,72,19,43,10,175
9,49,92,39,34,223
65,78,77,82,84,386
78,46,68,63,95,350
35,13,91,40,21,200
43,27,48,81,85,284
22,48,11,27,77,185
25,15,30,29,24,123
34,45,5,34,71,189
45,19,86,64,71,285
79,10,47,28,89,253
7,21,76,5,27,136
19,82,17,85,71,274
33,19,60,48,83,243
88,41,95,82,11,317
17,6,65,56,4,148
30,75,42,39,89,275
7,60,55,38,65,225
2,94,48,22,38,204
59,15,43,7,99,223
70,54,87,52,40,303
7,69,16,46,92,230
9,63,94,45,58,269
25,19,44,71,63,222
79,99,74,95,4,351
12,89,53,75,78,307
25,90,6,26,9,156
65,62,5,79,11,222
56,2,10,69,6,143
40,34,75,50,69,268
7,52,53,75,25,212
4,32,20,14,80,150
88,60,11,21,56,236
57,48,62,13,81,261
81,97,31,77,27,313
75,21,85,41,64,286
41,20,12,41,82,196
44,48,13,48,55,208
69,42,92,45,47,295
48,71,68,83,28,298
41,97,67,12,85,302
68,88,76,45,42,319
40,8,67,32,76,223
55,42,99,98,36,330
78,18,71,80,41,288
71,19,35,72,5,202
62,46,4,99,85,296
88,56,31,90,63,328
94,3,38,10,51,196
32,2,14,45,2,95
67,70,27,45,29,238
85,7,45,76,68,281
7,92,59,33,70,261
21,12,70,98,66,267
78,43,34,85,84,324
50,29,48,22,81,230
55,4,51,62,42,214
89,17,27,42,71,246
82,86,34,77,9,288
70,32,54,65,25,246
8,32,37,89,73,239
27,93,98,2,94,314
88,24,62,53,45,272
92,76,22,19,50,259
73,97,38,43,38,289
61,38,74,68,4,245
45,71,84,78,71,349
69,9,19,26,47,170
20,36,89,48,95,288
68,63,34,16,64,245
31,19,61,95,65,271
20,3,35,4,42,104
68,86,13,77,73,317
69,81,78,73,46,347
31,34,49,82,66,262
57,44,38,42,10,191
2,36,33,44,74,189
14,15,68,82,31,210
44,18,92,49,77,280
15,45,43,2,63,168
57,1,61,46,37,202
90,50,32,95,60,327
33,12,87,91,53,276
85,48,9,8,87,237
84,17,96,35,34,266
35,27,60,68,89,279
95,53,10,16,2,176
83,39,42,31,90,285
80,19,78,21,82,280
54,81,87,55,75,352
80,59,68,55,95,357
28,71,10,35,7,151
38,29,8,17,50,142
48,26,21,37,95,227
78,5,21,46,27,177
82,100,29,77,36,324
34,49,58,12,72,225
51,99,22,8,62,242
64,73,45,80,51,313
45,48,11,60,96,260
51,31,48,17,33,180
40,71,81,25,90,307
55,50,30,91,43,269
54,56,13,14,46,183
28,98,12,49,52,239
8,78,32,20,59,197
22,95,86,31,100,334
75,78,7,41,6,207
23,98,69,66,33,289
9,59,92,65,22,247
90,78,93,32,58,351
3,30,98,56,74,261
46,99,41,97,57,340
85,92,57,88,17,339
73,93,96,35,8,305
68,14,55,99,22,258
58,40,93,82,98,371
88,79,82,77,62,388
6,92,82,73,40,293
42,36,7,48,92,225
42,58,91,81,64,336
99,24,88,86,71,368
27,27,20,40,54,168
55,13,2,94,23,187
83,96,14,7,80,280
53,55,4,45,85,242
52,35,33,80,2,202
92,89,64,72,35,352
15,46,28,10,99,198
91,33,33,47,34,238
21,8,86,31,95,241
14,4,49,92,31,190
68,72,38,78,12,268
74,1,75,98,36,284
90,97,97,44,19,347
23,29,46,91,9,198
15,7,91,32,84,229
43,96,58,26,71,294
17,76,41,80,8,222
97,94,2,93,3,289
82,8,82,38,31,241
83,7,46,35,59,230
37,12,2,60,76,187
40,61,20,25,75,221
5,38,94,85,36,258
1,31,58,89,66,245
68,83,58,2,59,270
7,39,17,63,72,198
11,65,59,34,61,230
25,55,61,96,98,335
2,54,22,58,67,203
83,43,79,74,94,373
97,94,60,86,53,390
2,6,71,81,68,228
63,62,70,30,51,276
34,85,28,71,60,278
88,94,41,82,24,329
79,93,94,11,77,354
13,73,44,48,97,275
65,3,50,51,41,210
42,93,6,17,99,257
9,40,57,16,21,143
45,86,68,89,83,371
63,23,86,52,12,236
69,59,69,62,4,263
89,92,43,100,22,346
73,35,24,76,41,249
59,70,24,65,97,315
89,22,20,79,15,225
9,1,2,27,97,136
19,2,4,47,71,143
46,10,63,53,55,227
9,29,17,22,61,138
77,20,52,90,1,240
98,23,49,55,66,291
56,85,82,63,49,335
44,75,87,53,68,327
34,38,97,34,38,241
97,40,95,45,55,332
22,22,13,70,84,211
31,80,74,40,16,241
75,65,39,75,28,282
63,85,15,14,39,216
22,14,43,29,4,112
85,41,1,60,56,243
85,70,4,42,72,273
50,53,24,58,64,249
16,48,64,64,11,203
91,100,46,63,7,307
46,49,24,4,25,148
65,46,21,83,8,223
21,47,40,62,52,222
24,54,40,54,1,173
14,93,65,81,3,256
80,45,64,70,75,334
56,3,90,91,31,271
10,87,66,2,95,260
74,42,100,92,79,387
71,34,62,78,71,316
51,10,20,45,18,144
56,81,20,54,24,235
97,39,35,28,94,293
41,85,78,63,27,294
61,87,17,57,77,299
59,66,92,17,33,267
35,45,82,8,42,212
74,20,85,80,25,284
94,38,10,51,23,216
81,98,3,85,100,367
81,42,3,73,82,281
57,83,25,70,92,327
98,42,22,1,31,194
94,42,97,83,43,359
40,75,83,71,93,362
98,17,12,26,10,163
95,99,1,91,92,378
86,53,49,31,41,260
64,87,22,12,26,211
74,15,42,42,77,250
12,67,16,60,44,199
90,55,34,59,31,269
34,35,85,23,41,218
77,90,2,82,16,267
62,71,42,81,35,291
90,89,18,64,48,309
93,64,98,35,90,380
25,69,48,62,54,258
74,18,17,74,74,257
46,91,42,48,70,297
50,79,29,50,13,221
2,54,30,35,43,164
24,10,39,21,57,151
68,4,78,38,1,189
48,63,10,35,54,210
16,33,24,91,72,236
2,85,32,78,35,232
30,34,69,58,99,290
23,35,33,31,90,212
68,48,8,41,90,255
59,7,95,16,25,202
86,77,75,97,7,342
49,83,39,3,74,248
15,60,65,71,96,307
53,50,62,34,24,223
93,79,27,36,56,291
37,6,13,50,31,137
24,39,41,39,97,240
33,18,80,39,24,194
71,12,41,1,1,126
85,49,51,18,12,215
7,94,89,90,31,311
90,22,29,88,36,265
13,20,38,4,3,78
76,59,48,82,9,274
86,94,64,62,67,373
25,45,59,86,20,235
29,57,85,14,61,246
42,90,86,46,52,316
21,15,16,88,67,207
19,67,20,4,97,207
74,21,79,44,9,227
36,77,76,93,62,344
95,21,69,83,22,290
12,60,28,26,61,187
92,60,96,60,97,405
22,93,19,94,40,268
28,63,76,83,30,280
22,51,53,78,83,287
50,13,32,78,88,261
26,41,45,36,81,229
17,12,68,85,40,222
19,31,43,42,51,186
27,82,80,37,76,302
70,39,70,39,35,253
30,100,24,70,57,281
90,16,20,50,36,212
